0
0-0
bbbbbbbbbb
b000b0000b
b00000000b
b00012000b
b00034000b
b0000b000b
b0000bb00b
b0000b000b
b00000056b
b00000078b
bbbbbbbbbb