0
0-1
bbbbbbbbbb
b000b0000b
b0000bbbbb
b00012000b
b00034000b
b0000b000b
b0000000bb
bbbb0b000b
b0000b560b
b0000b780b
bbbbbbbbbb